.....*....
.....**...
......*...
.....***..
....**.**.
....*.....

Input
Lines width